1111111111
1000000001
1110000001
100100000011111
1001000010000001111
11100010000010001
10000000000000001
11111111111101111
10000000000000001
10000000000000001
10000000000000001
10000000000000001
10000000000000001