SO ./texture_siciliana pinco pallino
NO    ./texture_di_prova



F       255,   0,  0,,,,


    C       0,   0,  255,,,,




   EA ./texture_cinese


   WE     ./texture_occidentale



   1111111111
   11000000001
1110000001111
100100000011111
1001000010000001111
11100010000010001
10000000000000001                    111111111
1111111111110111111111111111111111   1000000001
1000000000000000110000000000000E01   1000000001
100000000000000010000000000000001   11111111111
100000000000000010000000000000001              
10000000000000001000000000000000111111111111111
10000000000000000000000000000000000000000000001
10000000000000001000000000000000000000000000001
10000000000000001000000000000000000000000000001
11111111111111111111111111111111111111111111111