NO   ./textures/colorstone.xpm

SO 			./textures/greystone.xpm


F       151, 00, 25,


    C       255,   102,  204     




   EA ./textures/redbrick.xpm





   WE     ./textures/wood.xpm

11111111111111111111111111111111111111111111111
10000000000000000000000000000000000000000000001
10000000000000001000000000000000000000000000001
10000000000000001000000000000000000000000000001
11111111111111111111111111111111111111111111111
11111111111111111111111111111111111111111111111
1000000000000000000000000000000000000000000000111111111
10000000000000000000000S0000000000000000000000001010101
1000000000000000000000000000000000000000000000111111111
10111111111111111111111111111111111111111111111
10111111111111111111111111111111111111111111111
10111111111111111111111111111111111111111111111
10111111111111111111111111111111111111111111111
10111111111111111111111111111111111111111111111
10111111111111111111111111111111111111111111111
10111111111111111111111111111111111111111111111
10111111111111111111111111111111111111111111111
10111111111111111111111111111111111111111111111
10111111111111111111111111111111111111111111111
10111111111111111111111111111111111111111111111
10111111111111111111111111111111111111111111111
10111111111111111111111111111111111111111111111
10111111111111111111111111111111111111111111111
10111111111111111111111111111111111111111111111
10111111111111111111111111111111111111111111111
10111111111111111111111111111111111111111111111
10111111111111111111111111111111111111111111111
10111111111111111111111111111111111111111111111
10111111111111111111111111111111111111111111111
10111111111111111111111111111111111111111111111
10111111111111111111111111111111111111111111111
10111111111111111111111111111111111111111111111
10111111111111111111111111111111111111111111111
10111111111111111111111111111111111111111111111
10111111111111111111111111111111111111111111111
10111111111111111111111111111111111111111111111
10111111111111111111111111111111111111111111111
10111111111111111111111111111111111111111111111
10111111111111111111111111111111111111111111111
10111111111111111111111111111111111111111111111
10111111111111111111111111111111111111111111111
10111111111111111111111111111111111111111111111
10111111111111111111111111111111111111111111111
10111111111111111111111111111111111111111111111
10111111111111111111111111111111111111111111111
10111111111111111111111111111111111111111111111
10111111111111111111111111111111111111111111111
10111111111111111111111111111111111111111111111
10111111111111111111111111111111111111111111111
10111111111111111111111111111111111111111111111
10111111111111111111111111111111111111111111111
10111111111111111111111111111111111111111111111
10111111111111111111111111111111111111111111111
10111111111111111111111111111111111111111111111
10111111111111111111111111111111111111111111111
10111111111111111111111111111111111111111111111		
10111111111111111111111111111111111111111111111     
101 
101
111
 
111
101
111