NO   ./textures/colorstone.xpm

SO 			./textures/greystone.xpm


F       151, 00, 25,


    C       255,   102,  204     




   EA ./textures/redbrick.xpm





   WE     ./textures/wood.xpm

11111
10N01
1111
                                      
11111
10001
11111