    1111111111
   11000000001
1110000001111
100100000011111
1001000010000001111
1110001E000010001
10000000000000001
11111111111101111
10000000000000001
10000000000000001
10000000000000001
10000000000000001
10000000000000001